"filename", "language", "C", "Makefile", "C++", "Markdown", "comment", "blank", "total"
"/home/xiangui/ysyx-workbench/nemu/Makefile", "Makefile", 0, 30, 0, 0, 22, 10, 62
"/home/xiangui/ysyx-workbench/nemu/README.md", "Markdown", 0, 0, 0, 33, 0, 3, 36
"/home/xiangui/ysyx-workbench/nemu/include/common.h", "C", 26, 0, 0, 0, 14, 10, 50
"/home/xiangui/ysyx-workbench/nemu/include/cpu/cpu.h", "C++", 0, 0, 9, 0, 14, 7, 30
"/home/xiangui/ysyx-workbench/nemu/include/cpu/decode.h", "C++", 0, 0, 75, 0, 16, 12, 103
"/home/xiangui/ysyx-workbench/nemu/include/cpu/difftest.h", "C++", 0, 0, 33, 0, 14, 7, 54
"/home/xiangui/ysyx-workbench/nemu/include/cpu/ifetch.h", "C++", 0, 0, 8, 0, 14, 5, 27
"/home/xiangui/ysyx-workbench/nemu/include/debug.h", "C++", 0, 0, 22, 0, 14, 8, 44
"/home/xiangui/ysyx-workbench/nemu/include/device/alarm.h", "C", 6, 0, 0, 0, 14, 5, 25
"/home/xiangui/ysyx-workbench/nemu/include/device/map.h", "C++", 0, 0, 32, 0, 15, 10, 57
"/home/xiangui/ysyx-workbench/nemu/include/device/mmio.h", "C++", 0, 0, 6, 0, 14, 5, 25
"/home/xiangui/ysyx-workbench/nemu/include/difftest-def.h", "C++", 0, 0, 21, 0, 14, 6, 41
"/home/xiangui/ysyx-workbench/nemu/include/isa.h", "C", 25, 0, 0, 0, 23, 11, 59
"/home/xiangui/ysyx-workbench/nemu/include/macro.h", "C++", 0, 0, 53, 0, 40, 18, 111
"/home/xiangui/ysyx-workbench/nemu/include/memory/host.h", "C++", 0, 0, 22, 0, 14, 7, 43
"/home/xiangui/ysyx-workbench/nemu/include/memory/paddr.h", "C++", 0, 0, 14, 0, 16, 8, 38
"/home/xiangui/ysyx-workbench/nemu/include/memory/vaddr.h", "C++", 0, 0, 10, 0, 14, 6, 30
"/home/xiangui/ysyx-workbench/nemu/include/utils.h", "C++", 0, 0, 45, 0, 17, 16, 78
"/home/xiangui/ysyx-workbench/nemu/resource/debian/README.md", "Markdown", 0, 0, 0, 141, 0, 32, 173
"/home/xiangui/ysyx-workbench/nemu/resource/mips-elf/README.md", "Markdown", 0, 0, 0, 1, 0, 1, 2
"/home/xiangui/ysyx-workbench/nemu/resource/sdcard/README.md", "Markdown", 0, 0, 0, 46, 0, 13, 59
"/home/xiangui/ysyx-workbench/nemu/resource/sdcard/nemu.c", "C", 394, 0, 0, 0, 40, 109, 543
"/home/xiangui/ysyx-workbench/nemu/scripts/build.mk", "Makefile", 0, 40, 0, 0, 5, 14, 59
"/home/xiangui/ysyx-workbench/nemu/scripts/config.mk", "Makefile", 0, 40, 0, 0, 15, 16, 71
"/home/xiangui/ysyx-workbench/nemu/scripts/native.mk", "Makefile", 0, 23, 0, 0, 16, 13, 52
"/home/xiangui/ysyx-workbench/nemu/src/cpu/cpu-exec.c", "C", 121, 0, 0, 0, 29, 21, 171
"/home/xiangui/ysyx-workbench/nemu/src/cpu/difftest/dut.c", "C", 81, 0, 0, 0, 30, 25, 136
"/home/xiangui/ysyx-workbench/nemu/src/cpu/difftest/ref.c", "C", 21, 0, 0, 0, 15, 7, 43
"/home/xiangui/ysyx-workbench/nemu/src/device/alarm.c", "C", 30, 0, 0, 0, 14, 8, 52
"/home/xiangui/ysyx-workbench/nemu/src/device/audio.c", "C", 27, 0, 0, 0, 14, 7, 48
"/home/xiangui/ysyx-workbench/nemu/src/device/device.c", "C", 65, 0, 0, 0, 15, 12, 92
"/home/xiangui/ysyx-workbench/nemu/src/device/disk.c", "C", 3, 0, 0, 0, 14, 3, 20
"/home/xiangui/ysyx-workbench/nemu/src/device/filelist.mk", "Makefile", 0, 15, 0, 0, 14, 4, 33
"/home/xiangui/ysyx-workbench/nemu/src/device/intr.c", "C", 3, 0, 0, 0, 14, 3, 20
"/home/xiangui/ysyx-workbench/nemu/src/device/io/map.c", "C", 46, 0, 0, 0, 15, 10, 71
"/home/xiangui/ysyx-workbench/nemu/src/device/io/mmio.c", "C", 37, 0, 0, 0, 16, 11, 64
"/home/xiangui/ysyx-workbench/nemu/src/device/io/port-io.c", "C", 26, 0, 0, 0, 16, 8, 50
"/home/xiangui/ysyx-workbench/nemu/src/device/keyboard.c", "C", 69, 0, 0, 0, 15, 17, 101
"/home/xiangui/ysyx-workbench/nemu/src/device/mmc.h", "C++", 0, 0, 275, 0, 117, 48, 440
"/home/xiangui/ysyx-workbench/nemu/src/device/sdcard.c", "C", 102, 0, 0, 0, 20, 13, 135
"/home/xiangui/ysyx-workbench/nemu/src/device/serial.c", "C", 25, 0, 0, 0, 17, 10, 52
"/home/xiangui/ysyx-workbench/nemu/src/device/timer.c", "C", 29, 0, 0, 0, 14, 6, 49
"/home/xiangui/ysyx-workbench/nemu/src/device/vga.c", "C", 62, 0, 0, 0, 16, 15, 93
"/home/xiangui/ysyx-workbench/nemu/src/engine/filelist.mk", "Makefile", 0, 2, 0, 0, 14, 2, 18
"/home/xiangui/ysyx-workbench/nemu/src/engine/interpreter/hostcall.c", "C", 31, 0, 0, 0, 14, 7, 52
"/home/xiangui/ysyx-workbench/nemu/src/engine/interpreter/init.c", "C", 9, 0, 0, 0, 15, 4, 28
"/home/xiangui/ysyx-workbench/nemu/src/filelist.mk", "Makefile", 0, 11, 0, 0, 14, 4, 29
"/home/xiangui/ysyx-workbench/nemu/src/isa/filelist.mk", "Makefile", 0, 2, 0, 0, 14, 2, 18
"/home/xiangui/ysyx-workbench/nemu/src/isa/loongarch32r/difftest/dut.c", "C", 8, 0, 0, 0, 20, 6, 34
"/home/xiangui/ysyx-workbench/nemu/src/isa/loongarch32r/include/isa-def.h", "C++", 0, 0, 14, 0, 15, 7, 36
"/home/xiangui/ysyx-workbench/nemu/src/isa/loongarch32r/init.c", "C", 17, 0, 0, 0, 20, 7, 44
"/home/xiangui/ysyx-workbench/nemu/src/isa/loongarch32r/inst.c", "C", 46, 0, 0, 0, 14, 13, 73
"/home/xiangui/ysyx-workbench/nemu/src/isa/loongarch32r/local-include/reg.h", "C++", 0, 0, 13, 0, 14, 7, 34
"/home/xiangui/ysyx-workbench/nemu/src/isa/loongarch32r/logo.c", "C", 1, 0, 0, 0, 14, 2, 17
"/home/xiangui/ysyx-workbench/nemu/src/isa/loongarch32r/reg.c", "C", 13, 0, 0, 0, 14, 5, 32
"/home/xiangui/ysyx-workbench/nemu/src/isa/loongarch32r/system/intr.c", "C", 7, 0, 0, 0, 17, 5, 29
"/home/xiangui/ysyx-workbench/nemu/src/isa/loongarch32r/system/mmu.c", "C", 6, 0, 0, 0, 14, 3, 23
"/home/xiangui/ysyx-workbench/nemu/src/isa/mips32/difftest/dut.c", "C", 8, 0, 0, 0, 14, 4, 26
"/home/xiangui/ysyx-workbench/nemu/src/isa/mips32/include/isa-def.h", "C++", 0, 0, 15, 0, 15, 7, 37
"/home/xiangui/ysyx-workbench/nemu/src/isa/mips32/init.c", "C", 16, 0, 0, 0, 20, 7, 43
"/home/xiangui/ysyx-workbench/nemu/src/isa/mips32/inst.c", "C", 48, 0, 0, 0, 14, 13, 75
"/home/xiangui/ysyx-workbench/nemu/src/isa/mips32/local-include/reg.h", "C++", 0, 0, 13, 0, 14, 7, 34
"/home/xiangui/ysyx-workbench/nemu/src/isa/mips32/logo.c", "C", 49, 0, 0, 0, 26, 4, 79
"/home/xiangui/ysyx-workbench/nemu/src/isa/mips32/reg.c", "C", 13, 0, 0, 0, 14, 5, 32
"/home/xiangui/ysyx-workbench/nemu/src/isa/mips32/system/intr.c", "C", 7, 0, 0, 0, 17, 5, 29
"/home/xiangui/ysyx-workbench/nemu/src/isa/mips32/system/mmu.c", "C", 6, 0, 0, 0, 14, 3, 23
"/home/xiangui/ysyx-workbench/nemu/src/isa/riscv32/difftest/dut.c", "C", 22, 0, 0, 0, 14, 5, 41
"/home/xiangui/ysyx-workbench/nemu/src/isa/riscv32/include/isa-def.h", "C++", 0, 0, 14, 0, 15, 7, 36
"/home/xiangui/ysyx-workbench/nemu/src/isa/riscv32/init.c", "C", 17, 0, 0, 0, 20, 7, 44
"/home/xiangui/ysyx-workbench/nemu/src/isa/riscv32/inst.c", "C", 149, 0, 0, 0, 14, 12, 175
"/home/xiangui/ysyx-workbench/nemu/src/isa/riscv32/local-include/reg.h", "C++", 0, 0, 13, 0, 14, 7, 34
"/home/xiangui/ysyx-workbench/nemu/src/isa/riscv32/logo.c", "C", 36, 0, 0, 0, 24, 4, 64
"/home/xiangui/ysyx-workbench/nemu/src/isa/riscv32/reg.c", "C", 22, 0, 0, 0, 14, 4, 40
"/home/xiangui/ysyx-workbench/nemu/src/isa/riscv32/system/intr.c", "C", 7, 0, 0, 0, 17, 5, 29
"/home/xiangui/ysyx-workbench/nemu/src/isa/riscv32/system/mmu.c", "C", 6, 0, 0, 0, 14, 3, 23
"/home/xiangui/ysyx-workbench/nemu/src/memory/paddr.c", "C", 56, 0, 0, 0, 16, 14, 86
"/home/xiangui/ysyx-workbench/nemu/src/memory/vaddr.c", "C", 11, 0, 0, 0, 14, 5, 30
"/home/xiangui/ysyx-workbench/nemu/src/monitor/monitor.c", "C", 188, 0, 0, 0, 27, 33, 248
"/home/xiangui/ysyx-workbench/nemu/src/monitor/sdb/expr.c", "C", 265, 0, 0, 0, 32, 27, 324
"/home/xiangui/ysyx-workbench/nemu/src/monitor/sdb/sdb.c", "C", 159, 0, 0, 0, 24, 42, 225
"/home/xiangui/ysyx-workbench/nemu/src/monitor/sdb/sdb.h", "C", 20, 0, 0, 0, 15, 10, 45
"/home/xiangui/ysyx-workbench/nemu/src/monitor/sdb/watchpoint.c", "C", 104, 0, 0, 0, 17, 15, 136
"/home/xiangui/ysyx-workbench/nemu/src/nemu-main.c", "C", 15, 0, 0, 0, 16, 4, 35
"/home/xiangui/ysyx-workbench/nemu/src/utils/disasm.cc", "C++", 0, 0, 82, 0, 14, 14, 110
"/home/xiangui/ysyx-workbench/nemu/src/utils/filelist.mk", "Makefile", 0, 5, 0, 0, 14, 2, 21
"/home/xiangui/ysyx-workbench/nemu/src/utils/log.c", "C", 16, 0, 0, 0, 14, 5, 35
"/home/xiangui/ysyx-workbench/nemu/src/utils/state.c", "C", 7, 0, 0, 0, 14, 4, 25
"/home/xiangui/ysyx-workbench/nemu/src/utils/timer.c", "C", 29, 0, 0, 0, 14, 7, 50
"/home/xiangui/ysyx-workbench/nemu/tools/difftest.mk", "Makefile", 0, 11, 0, 0, 14, 4, 29
"/home/xiangui/ysyx-workbench/nemu/tools/fixdep/Makefile", "Makefile", 0, 3, 0, 0, 0, 1, 4
"/home/xiangui/ysyx-workbench/nemu/tools/fixdep/fixdep.c", "C", 222, 0, 0, 0, 138, 45, 405
"/home/xiangui/ysyx-workbench/nemu/tools/gen-expr/Makefile", "Makefile", 0, 3, 0, 0, 14, 2, 19
"/home/xiangui/ysyx-workbench/nemu/tools/gen-expr/gen-expr.c", "C", 108, 0, 0, 0, 16, 23, 147
"/home/xiangui/ysyx-workbench/nemu/tools/kconfig/Makefile", "Makefile", 0, 32, 0, 0, 0, 9, 41
"/home/xiangui/ysyx-workbench/nemu/tools/kconfig/conf.c", "C", 637, 0, 0, 0, 35, 56, 728
"/home/xiangui/ysyx-workbench/nemu/tools/kconfig/confdata.c", "C", 1051, 0, 0, 0, 116, 172, 1339
"/home/xiangui/ysyx-workbench/nemu/tools/kconfig/expr.c", "C", 1072, 0, 0, 0, 138, 94, 1304
"/home/xiangui/ysyx-workbench/nemu/tools/kconfig/expr.h", "C++", 0, 0, 185, 0, 91, 57, 333
"/home/xiangui/ysyx-workbench/nemu/tools/kconfig/list.h", "C++", 0, 0, 55, 0, 61, 17, 133
"/home/xiangui/ysyx-workbench/nemu/tools/kconfig/lkc.h", "C++", 0, 0, 130, 0, 14, 30, 174
"/home/xiangui/ysyx-workbench/nemu/tools/kconfig/lkc_proto.h", "C++", 0, 0, 40, 0, 5, 7, 52
"/home/xiangui/ysyx-workbench/nemu/tools/kconfig/lxdialog/checklist.c", "C", 237, 0, 0, 0, 37, 46, 320
"/home/xiangui/ysyx-workbench/nemu/tools/kconfig/lxdialog/dialog.h", "C++", 0, 0, 176, 0, 38, 25, 239
"/home/xiangui/ysyx-workbench/nemu/tools/kconfig/lxdialog/inputbox.c", "C", 245, 0, 0, 0, 16, 29, 290
"/home/xiangui/ysyx-workbench/nemu/tools/kconfig/lxdialog/menubox.c", "C", 302, 0, 0, 0, 68, 55, 425
"/home/xiangui/ysyx-workbench/nemu/tools/kconfig/lxdialog/textbox.c", "C", 310, 0, 0, 0, 44, 42, 396
"/home/xiangui/ysyx-workbench/nemu/tools/kconfig/lxdialog/util.c", "C", 542, 0, 0, 0, 63, 96, 701
"/home/xiangui/ysyx-workbench/nemu/tools/kconfig/lxdialog/yesno.c", "C", 70, 0, 0, 0, 14, 18, 102
"/home/xiangui/ysyx-workbench/nemu/tools/kconfig/mconf.c", "C", 953, 0, 0, 0, 16, 72, 1041
"/home/xiangui/ysyx-workbench/nemu/tools/kconfig/menu.c", "C", 621, 0, 0, 0, 175, 104, 900
"/home/xiangui/ysyx-workbench/nemu/tools/kconfig/preprocess.c", "C", 383, 0, 0, 0, 87, 105, 575
"/home/xiangui/ysyx-workbench/nemu/tools/kconfig/symbol.c", "C", 1067, 0, 0, 0, 83, 165, 1315
"/home/xiangui/ysyx-workbench/nemu/tools/kconfig/util.c", "C", 102, 0, 0, 0, 11, 17, 130
"/home/xiangui/ysyx-workbench/nemu/tools/kvm-diff/Makefile", "Makefile", 0, 6, 0, 0, 14, 4, 24
"/home/xiangui/ysyx-workbench/nemu/tools/kvm-diff/include/paddr.h", "C++", 0, 0, 0, 0, 15, 2, 17
"/home/xiangui/ysyx-workbench/nemu/tools/kvm-diff/src/kvm.c", "C", 327, 0, 0, 0, 29, 53, 409
"/home/xiangui/ysyx-workbench/nemu/tools/qemu-diff/Makefile", "Makefile", 0, 6, 0, 0, 14, 4, 24
"/home/xiangui/ysyx-workbench/nemu/tools/qemu-diff/include/common.h", "C", 13, 0, 0, 0, 14, 6, 33
"/home/xiangui/ysyx-workbench/nemu/tools/qemu-diff/include/isa.h", "C", 41, 0, 0, 0, 14, 5, 60
"/home/xiangui/ysyx-workbench/nemu/tools/qemu-diff/include/protocol.h", "C++", 0, 0, 10, 0, 18, 10, 38
"/home/xiangui/ysyx-workbench/nemu/tools/qemu-diff/src/diff-test.c", "C", 67, 0, 0, 0, 17, 16, 100
"/home/xiangui/ysyx-workbench/nemu/tools/qemu-diff/src/gdb-host.c", "C", 83, 0, 0, 0, 15, 21, 119
"/home/xiangui/ysyx-workbench/nemu/tools/qemu-diff/src/isa.c", "C", 43, 0, 0, 0, 21, 15, 79
"/home/xiangui/ysyx-workbench/nemu/tools/qemu-diff/src/protocol.c", "C", 208, 0, 0, 0, 43, 55, 306
"/home/xiangui/ysyx-workbench/nemu/tools/spike-diff/Makefile", "Makefile", 0, 30, 0, 0, 14, 11, 55
"/home/xiangui/ysyx-workbench/nemu/tools/spike-diff/difftest.cc", "C++", 0, 0, 100, 0, 14, 18, 132
"Total", "-", 11316, 259, 1485, 221, 3044, 2456, 18781