"filename", "language", "Makefile", "C", "C++", "Markdown", "Python", "comment", "blank", "total"
"/home/xiangui/ysyx-workbench/abstract-machine/Makefile", "Makefile", -95, 0, 0, 0, 0, -34, -35, -164
"/home/xiangui/ysyx-workbench/abstract-machine/am/Makefile", "Makefile", -4, 0, 0, 0, 0, 0, -2, -6
"/home/xiangui/ysyx-workbench/abstract-machine/am/include/am.h", "C", 0, -55, 0, 0, 0, -12, -15, -82
"/home/xiangui/ysyx-workbench/abstract-machine/am/include/amdev.h", "C++", 0, 0, -59, 0, 0, -3, -13, -75
"/home/xiangui/ysyx-workbench/abstract-machine/am/include/arch/loongarch32r-nemu.h", "C++", 0, 0, -12, 0, 0, -1, -4, -17
"/home/xiangui/ysyx-workbench/abstract-machine/am/include/arch/mips32-nemu.h", "C++", 0, 0, -12, 0, 0, -1, -4, -17
"/home/xiangui/ysyx-workbench/abstract-machine/am/include/arch/native.h", "C++", 0, 0, -19, 0, 0, -1, -7, -27
"/home/xiangui/ysyx-workbench/abstract-machine/am/include/arch/riscv.h", "C++", 0, 0, -21, 0, 0, -1, -6, -28
"/home/xiangui/ysyx-workbench/abstract-machine/am/include/arch/x86-nemu.h", "C++", 0, 0, -13, 0, 0, -1, -4, -18
"/home/xiangui/ysyx-workbench/abstract-machine/am/include/arch/x86-qemu.h", "C++", 0, 0, -14, 0, 0, 0, -4, -18
"/home/xiangui/ysyx-workbench/abstract-machine/am/include/arch/x86_64-qemu.h", "C++", 0, 0, -17, 0, 0, 0, -5, -22
"/home/xiangui/ysyx-workbench/abstract-machine/am/src/loongarch/loongarch32r.h", "C++", 0, 0, -16, 0, 0, -1, -8, -25
"/home/xiangui/ysyx-workbench/abstract-machine/am/src/loongarch/nemu/cte.c", "C", 0, -33, 0, 0, 0, -2, -13, -48
"/home/xiangui/ysyx-workbench/abstract-machine/am/src/loongarch/nemu/vme.c", "C", 0, -33, 0, 0, 0, 0, -10, -43
"/home/xiangui/ysyx-workbench/abstract-machine/am/src/mips/mips32.h", "C++", 0, 0, -16, 0, 0, -1, -8, -25
"/home/xiangui/ysyx-workbench/abstract-machine/am/src/mips/nemu/cte.c", "C", 0, -39, 0, 0, 0, -2, -14, -55
"/home/xiangui/ysyx-workbench/abstract-machine/am/src/mips/nemu/vme.c", "C", 0, -33, 0, 0, 0, 0, -10, -43
"/home/xiangui/ysyx-workbench/abstract-machine/am/src/native/cte.c", "C", 0, -145, 0, 0, 0, -21, -34, -200
"/home/xiangui/ysyx-workbench/abstract-machine/am/src/native/ioe.c", "C", 0, -71, 0, 0, 0, 0, -9, -80
"/home/xiangui/ysyx-workbench/abstract-machine/am/src/native/ioe/audio.c", "C", 0, -62, 0, 0, 0, 0, -11, -73
"/home/xiangui/ysyx-workbench/abstract-machine/am/src/native/ioe/disk.c", "C", 0, -35, 0, 0, 0, 0, -7, -42
"/home/xiangui/ysyx-workbench/abstract-machine/am/src/native/ioe/gpu.c", "C", 0, -56, 0, 0, 0, -1, -10, -67
"/home/xiangui/ysyx-workbench/abstract-machine/am/src/native/ioe/input.c", "C", 0, -54, 0, 0, 0, 0, -10, -64
"/home/xiangui/ysyx-workbench/abstract-machine/am/src/native/ioe/timer.c", "C", 0, -27, 0, 0, 0, 0, -6, -33
"/home/xiangui/ysyx-workbench/abstract-machine/am/src/native/mpe.c", "C", 0, -40, 0, 0, 0, 0, -12, -52
"/home/xiangui/ysyx-workbench/abstract-machine/am/src/native/platform.c", "C", 0, -152, 0, 0, 0, -40, -39, -231
"/home/xiangui/ysyx-workbench/abstract-machine/am/src/native/platform.h", "C++", 0, 0, -23, 0, 0, -1, -5, -29
"/home/xiangui/ysyx-workbench/abstract-machine/am/src/native/trm.c", "C", 0, -25, 0, 0, 0, 0, -6, -31
"/home/xiangui/ysyx-workbench/abstract-machine/am/src/native/vme.c", "C", 0, -116, 0, 0, 0, -3, -23, -142
"/home/xiangui/ysyx-workbench/abstract-machine/am/src/platform/dummy/cte.c", "C", 0, -14, 0, 0, 0, 0, -6, -20
"/home/xiangui/ysyx-workbench/abstract-machine/am/src/platform/dummy/ioe.c", "C", 0, -8, 0, 0, 0, 0, -4, -12
"/home/xiangui/ysyx-workbench/abstract-machine/am/src/platform/dummy/mpe.c", "C", 0, -13, 0, 0, 0, 0, -5, -18
"/home/xiangui/ysyx-workbench/abstract-machine/am/src/platform/dummy/trm.c", "C", 0, -7, 0, 0, 0, 0, -4, -11
"/home/xiangui/ysyx-workbench/abstract-machine/am/src/platform/dummy/vme.c", "C", 0, -13, 0, 0, 0, 0, -6, -19
"/home/xiangui/ysyx-workbench/abstract-machine/am/src/platform/nemu/include/nemu.h", "C++", 0, 0, -39, 0, 0, -1, -11, -51
"/home/xiangui/ysyx-workbench/abstract-machine/am/src/platform/nemu/ioe/audio.c", "C", 0, -20, 0, 0, 0, 0, -7, -27
"/home/xiangui/ysyx-workbench/abstract-machine/am/src/platform/nemu/ioe/disk.c", "C", 0, -9, 0, 0, 0, 0, -4, -13
"/home/xiangui/ysyx-workbench/abstract-machine/am/src/platform/nemu/ioe/gpu.c", "C", 0, -20, 0, 0, 0, 0, -6, -26
"/home/xiangui/ysyx-workbench/abstract-machine/am/src/platform/nemu/ioe/input.c", "C", 0, -7, 0, 0, 0, 0, -3, -10
"/home/xiangui/ysyx-workbench/abstract-machine/am/src/platform/nemu/ioe/ioe.c", "C", 0, -53, 0, 0, 0, 0, -7, -60
"/home/xiangui/ysyx-workbench/abstract-machine/am/src/platform/nemu/ioe/timer.c", "C", 0, -15, 0, 0, 0, 0, -4, -19
"/home/xiangui/ysyx-workbench/abstract-machine/am/src/platform/nemu/mpe.c", "C", 0, -16, 0, 0, 0, 0, -5, -21
"/home/xiangui/ysyx-workbench/abstract-machine/am/src/platform/nemu/trm.c", "C", 0, -20, 0, 0, 0, -1, -7, -28
"/home/xiangui/ysyx-workbench/abstract-machine/am/src/riscv/nemu/cte.c", "C", 0, -36, 0, 0, 0, -2, -13, -51
"/home/xiangui/ysyx-workbench/abstract-machine/am/src/riscv/nemu/vme.c", "C", 0, -57, 0, 0, 0, -1, -17, -75
"/home/xiangui/ysyx-workbench/abstract-machine/am/src/riscv/npc/cte.c", "C", 0, -36, 0, 0, 0, -2, -13, -51
"/home/xiangui/ysyx-workbench/abstract-machine/am/src/riscv/npc/input.c", "C", 0, -5, 0, 0, 0, 0, -2, -7
"/home/xiangui/ysyx-workbench/abstract-machine/am/src/riscv/npc/ioe.c", "C", 0, -25, 0, 0, 0, 0, -8, -33
"/home/xiangui/ysyx-workbench/abstract-machine/am/src/riscv/npc/libgcc/ashldi3.c", "C", 0, -22, 0, 0, 0, 0, -6, -28
"/home/xiangui/ysyx-workbench/abstract-machine/am/src/riscv/npc/libgcc/libgcc2.h", "C++", 0, 0, -421, 0, 0, -68, -55, -544
"/home/xiangui/ysyx-workbench/abstract-machine/am/src/riscv/npc/libgcc/longlong.h", "C++", 0, 0, -1539, 0, 0, -152, -84, -1775
"/home/xiangui/ysyx-workbench/abstract-machine/am/src/riscv/npc/libgcc/multi3.c", "C", 0, -45, 0, 0, 0, -32, -10, -87
"/home/xiangui/ysyx-workbench/abstract-machine/am/src/riscv/npc/libgcc/riscv-asm.h", "C++", 0, 0, -16, 0, 0, -20, -6, -42
"/home/xiangui/ysyx-workbench/abstract-machine/am/src/riscv/npc/libgcc/unused.c", "C", 0, -4, 0, 0, 0, 0, -2, -6
"/home/xiangui/ysyx-workbench/abstract-machine/am/src/riscv/npc/mpe.c", "C", 0, -13, 0, 0, 0, 0, -5, -18
"/home/xiangui/ysyx-workbench/abstract-machine/am/src/riscv/npc/timer.c", "C", 0, -14, 0, 0, 0, 0, -4, -18
"/home/xiangui/ysyx-workbench/abstract-machine/am/src/riscv/npc/trm.c", "C", 0, -21, 0, 0, 0, 0, -7, -28
"/home/xiangui/ysyx-workbench/abstract-machine/am/src/riscv/npc/vme.c", "C", 0, -13, 0, 0, 0, 0, -6, -19
"/home/xiangui/ysyx-workbench/abstract-machine/am/src/riscv/riscv.h", "C++", 0, 0, -27, 0, 0, 0, -8, -35
"/home/xiangui/ysyx-workbench/abstract-machine/am/src/riscv/spike/atomic.h", "C++", 0, 0, -62, 0, 0, -4, -13, -79
"/home/xiangui/ysyx-workbench/abstract-machine/am/src/riscv/spike/htif.c", "C", 0, -92, 0, 0, 0, -4, -16, -112
"/home/xiangui/ysyx-workbench/abstract-machine/am/src/riscv/spike/htif.h", "C++", 0, 0, -18, 0, 0, -1, -6, -25
"/home/xiangui/ysyx-workbench/abstract-machine/am/src/riscv/spike/ioe.c", "C", 0, -21, 0, 0, 0, 0, -7, -28
"/home/xiangui/ysyx-workbench/abstract-machine/am/src/riscv/spike/timer.c", "C", 0, -24, 0, 0, 0, 0, -7, -31
"/home/xiangui/ysyx-workbench/abstract-machine/am/src/riscv/spike/trm.c", "C", 0, -26, 0, 0, 0, -1, -8, -35
"/home/xiangui/ysyx-workbench/abstract-machine/am/src/x86/nemu/cte.c", "C", 0, -45, 0, 0, 0, -4, -19, -68
"/home/xiangui/ysyx-workbench/abstract-machine/am/src/x86/nemu/vme.c", "C", 0, -49, 0, 0, 0, -1, -15, -65
"/home/xiangui/ysyx-workbench/abstract-machine/am/src/x86/qemu/boot/Makefile", "Makefile", -7, 0, 0, 0, 0, 0, -2, -9
"/home/xiangui/ysyx-workbench/abstract-machine/am/src/x86/qemu/boot/genboot.py", "Python", 0, 0, 0, 0, -13, 0, -2, -15
"/home/xiangui/ysyx-workbench/abstract-machine/am/src/x86/qemu/boot/main.c", "C", 0, -77, 0, 0, 0, -3, -11, -91
"/home/xiangui/ysyx-workbench/abstract-machine/am/src/x86/qemu/cte.c", "C", 0, -141, 0, 0, 0, -1, -24, -166
"/home/xiangui/ysyx-workbench/abstract-machine/am/src/x86/qemu/ioe.c", "C", 0, -388, 0, 0, 0, -13, -71, -472
"/home/xiangui/ysyx-workbench/abstract-machine/am/src/x86/qemu/mpe.c", "C", 0, -46, 0, 0, 0, 0, -10, -56
"/home/xiangui/ysyx-workbench/abstract-machine/am/src/x86/qemu/trm.c", "C", 0, -101, 0, 0, 0, 0, -12, -113
"/home/xiangui/ysyx-workbench/abstract-machine/am/src/x86/qemu/vme.c", "C", 0, -160, 0, 0, 0, 0, -22, -182
"/home/xiangui/ysyx-workbench/abstract-machine/am/src/x86/qemu/x86-qemu.h", "C++", 0, 0, -79, 0, 0, -2, -20, -101
"/home/xiangui/ysyx-workbench/abstract-machine/am/src/x86/x86.h", "C++", 0, 0, -286, 0, 0, -16, -52, -354
"/home/xiangui/ysyx-workbench/abstract-machine/klib/Makefile", "Makefile", -3, 0, 0, 0, 0, 0, -1, -4
"/home/xiangui/ysyx-workbench/abstract-machine/klib/include/klib-macros.h", "C", 0, -30, 0, 0, 0, 0, -10, -40
"/home/xiangui/ysyx-workbench/abstract-machine/klib/include/klib.h", "C", 0, -45, 0, 0, 0, -5, -10, -60
"/home/xiangui/ysyx-workbench/abstract-machine/klib/src/cpp.c", "C", 0, -13, 0, 0, 0, 0, -7, -20
"/home/xiangui/ysyx-workbench/abstract-machine/klib/src/int64.c", "C", 0, -518, 0, 0, 0, -125, -89, -732
"/home/xiangui/ysyx-workbench/abstract-machine/klib/src/stdio.c", "C", 0, -87, 0, 0, 0, 0, -14, -101
"/home/xiangui/ysyx-workbench/abstract-machine/klib/src/stdlib.c", "C", 0, -70, 0, 0, 0, -4, -12, -86
"/home/xiangui/ysyx-workbench/abstract-machine/klib/src/string.c", "C", 0, -125, 0, 0, 0, -1, -14, -140
"/home/xiangui/ysyx-workbench/abstract-machine/scripts/isa/loongarch32r.mk", "Makefile", -4, 0, 0, 0, 0, 0, -1, -5
"/home/xiangui/ysyx-workbench/abstract-machine/scripts/isa/mips32.mk", "Makefile", -5, 0, 0, 0, 0, 0, -1, -6
"/home/xiangui/ysyx-workbench/abstract-machine/scripts/isa/riscv.mk", "Makefile", -6, 0, 0, 0, 0, -1, -2, -9
"/home/xiangui/ysyx-workbench/abstract-machine/scripts/isa/x86.mk", "Makefile", -5, 0, 0, 0, 0, 0, -1, -6
"/home/xiangui/ysyx-workbench/abstract-machine/scripts/isa/x86_64.mk", "Makefile", -4, 0, 0, 0, 0, 0, -1, -5
"/home/xiangui/ysyx-workbench/abstract-machine/scripts/loongarch32r-nemu.mk", "Makefile", -7, 0, 0, 0, 0, 0, -2, -9
"/home/xiangui/ysyx-workbench/abstract-machine/scripts/mips32-nemu.mk", "Makefile", -7, 0, 0, 0, 0, 0, -2, -9
"/home/xiangui/ysyx-workbench/abstract-machine/scripts/native.mk", "Makefile", -23, 0, 0, 0, 0, 0, -5, -28
"/home/xiangui/ysyx-workbench/abstract-machine/scripts/platform/nemu.mk", "Makefile", -27, 0, 0, 0, 0, 0, -7, -34
"/home/xiangui/ysyx-workbench/abstract-machine/scripts/platform/npc.mk", "Makefile", -20, 0, 0, 0, 0, 0, -5, -25
"/home/xiangui/ysyx-workbench/abstract-machine/scripts/platform/qemu.mk", "Makefile", -13, 0, 0, 0, 0, 0, -5, -18
"/home/xiangui/ysyx-workbench/abstract-machine/scripts/riscv32-nemu.mk", "Makefile", -9, 0, 0, 0, 0, 0, -2, -11
"/home/xiangui/ysyx-workbench/abstract-machine/scripts/riscv32e-nemu.mk", "Makefile", -9, 0, 0, 0, 0, 0, -2, -11
"/home/xiangui/ysyx-workbench/abstract-machine/scripts/riscv32e-npc.mk", "Makefile", -9, 0, 0, 0, 0, 0, -2, -11
"/home/xiangui/ysyx-workbench/abstract-machine/scripts/riscv64-nemu.mk", "Makefile", -7, 0, 0, 0, 0, 0, -2, -9
"/home/xiangui/ysyx-workbench/abstract-machine/scripts/spike.mk", "Makefile", -15, 0, 0, 0, 0, 0, -5, -20
"/home/xiangui/ysyx-workbench/abstract-machine/scripts/x86-nemu.mk", "Makefile", -8, 0, 0, 0, 0, -1, -2, -11
"/home/xiangui/ysyx-workbench/abstract-machine/scripts/x86-qemu.mk", "Makefile", -11, 0, 0, 0, 0, 0, -3, -14
"/home/xiangui/ysyx-workbench/abstract-machine/scripts/x86_64-qemu.mk", "Makefile", -11, 0, 0, 0, 0, 0, -3, -14
"/home/xiangui/ysyx-workbench/abstract-machine/tools/logisim-img.py", "Python", 0, 0, 0, 0, -22, -1, -6, -29
"/home/xiangui/ysyx-workbench/am-kernels/benchmarks/coremark/Makefile", "Makefile", 3, 0, 0, 0, 0, 0, 1, 4
"/home/xiangui/ysyx-workbench/am-kernels/benchmarks/coremark/README.md", "Markdown", 0, 0, 0, 188, 0, 0, 44, 232
"/home/xiangui/ysyx-workbench/am-kernels/benchmarks/coremark/include/core_portme.h", "C++", 0, 0, 79, 0, 0, 90, 20, 189
"/home/xiangui/ysyx-workbench/am-kernels/benchmarks/coremark/include/coremark.h", "C++", 0, 0, 107, 0, 0, 43, 25, 175
"/home/xiangui/ysyx-workbench/am-kernels/benchmarks/coremark/src/core_list_join.c", "C", 0, 270, 0, 0, 0, 195, 32, 497
"/home/xiangui/ysyx-workbench/am-kernels/benchmarks/coremark/src/core_main.c", "C", 0, 263, 0, 0, 0, 62, 15, 340
"/home/xiangui/ysyx-workbench/am-kernels/benchmarks/coremark/src/core_matrix.c", "C", 0, 184, 0, 0, 0, 108, 17, 309
"/home/xiangui/ysyx-workbench/am-kernels/benchmarks/coremark/src/core_portme.c", "C", 0, 54, 0, 0, 0, 46, 10, 110
"/home/xiangui/ysyx-workbench/am-kernels/benchmarks/coremark/src/core_state.c", "C", 0, 208, 0, 0, 0, 60, 10, 278
"/home/xiangui/ysyx-workbench/am-kernels/benchmarks/coremark/src/core_util.c", "C", 0, 165, 0, 0, 0, 38, 8, 211
"/home/xiangui/ysyx-workbench/am-kernels/benchmarks/dhrystone/Makefile", "Makefile", 3, 0, 0, 0, 0, 0, 1, 4
"/home/xiangui/ysyx-workbench/am-kernels/benchmarks/dhrystone/dry.c", "C", 0, 426, 0, 0, 0, 431, 94, 951
"/home/xiangui/ysyx-workbench/am-kernels/benchmarks/microbench/Makefile", "Makefile", 3, 0, 0, 0, 0, 0, 1, 4
"/home/xiangui/ysyx-workbench/am-kernels/benchmarks/microbench/README.md", "Markdown", 0, 0, 0, 48, 0, 0, 21, 69
"/home/xiangui/ysyx-workbench/am-kernels/benchmarks/microbench/include/benchmark.h", "C++", 0, 0, 98, 0, 0, 5, 21, 124
"/home/xiangui/ysyx-workbench/am-kernels/benchmarks/microbench/src/15pz/15pz.cc", "C++", 0, 0, 73, 0, 0, 1, 23, 97
"/home/xiangui/ysyx-workbench/am-kernels/benchmarks/microbench/src/15pz/heap.h", "C++", 0, 0, 179, 0, 0, 7, 42, 228
"/home/xiangui/ysyx-workbench/am-kernels/benchmarks/microbench/src/15pz/puzzle.h", "C++", 0, 0, 305, 0, 0, 71, 100, 476
"/home/xiangui/ysyx-workbench/am-kernels/benchmarks/microbench/src/bench.c", "C", 0, 162, 0, 0, 0, 4, 34, 200
"/home/xiangui/ysyx-workbench/am-kernels/benchmarks/microbench/src/bf/bf.c", "C", 0, 113, 0, 0, 0, 22, 17, 152
"/home/xiangui/ysyx-workbench/am-kernels/benchmarks/microbench/src/dinic/dinic.cc", "C++", 0, 0, 117, 0, 0, 0, 22, 139
"/home/xiangui/ysyx-workbench/am-kernels/benchmarks/microbench/src/fib/fib.c", "C", 0, 52, 0, 0, 0, 1, 12, 65
"/home/xiangui/ysyx-workbench/am-kernels/benchmarks/microbench/src/lzip/lzip.c", "C", 0, 23, 0, 0, 0, 0, 7, 30
"/home/xiangui/ysyx-workbench/am-kernels/benchmarks/microbench/src/lzip/quicklz.c", "C", 0, 669, 0, 0, 0, 14, 79, 762
"/home/xiangui/ysyx-workbench/am-kernels/benchmarks/microbench/src/lzip/quicklz.h", "C++", 0, 0, 106, 0, 0, 31, 28, 165
"/home/xiangui/ysyx-workbench/am-kernels/benchmarks/microbench/src/md5/md5.c", "C", 0, 108, 0, 0, 0, 22, 30, 160
"/home/xiangui/ysyx-workbench/am-kernels/benchmarks/microbench/src/qsort/qsort.c", "C", 0, 36, 0, 0, 0, 0, 9, 45
"/home/xiangui/ysyx-workbench/am-kernels/benchmarks/microbench/src/queen/queen.c", "C", 0, 26, 0, 0, 0, 0, 7, 33
"/home/xiangui/ysyx-workbench/am-kernels/benchmarks/microbench/src/sieve/sieve.c", "C", 0, 35, 0, 0, 0, 0, 8, 43
"/home/xiangui/ysyx-workbench/am-kernels/benchmarks/microbench/src/ssort/ssort.cc", "C++", 0, 0, 81, 0, 0, 12, 19, 112
"/home/xiangui/ysyx-workbench/am-kernels/kernels/demo/Makefile", "Makefile", 3, 0, 0, 0, 0, 0, 1, 4
"/home/xiangui/ysyx-workbench/am-kernels/kernels/demo/include/io.h", "C++", 0, 0, 81, 0, 0, 0, 17, 98
"/home/xiangui/ysyx-workbench/am-kernels/kernels/demo/src/aclock/aclock.c", "C", 0, 184, 0, 0, 0, 23, 13, 220
"/home/xiangui/ysyx-workbench/am-kernels/kernels/demo/src/ant/ant.c", "C", 0, 56, 0, 0, 0, 1, 14, 71
"/home/xiangui/ysyx-workbench/am-kernels/kernels/demo/src/bf/bf.c", "C", 0, 73, 0, 0, 0, 18, 8, 99
"/home/xiangui/ysyx-workbench/am-kernels/kernels/demo/src/bf/mandelbrot.h", "C++", 0, 0, 146, 0, 0, 0, 1, 147
"/home/xiangui/ysyx-workbench/am-kernels/kernels/demo/src/cmatrix/cmatrix.c", "C", 0, 50, 0, 0, 0, 12, 11, 73
"/home/xiangui/ysyx-workbench/am-kernels/kernels/demo/src/donut/donut.c", "C", 0, 61, 0, 0, 0, 12, 10, 83
"/home/xiangui/ysyx-workbench/am-kernels/kernels/demo/src/galton/galton.c", "C", 0, 82, 0, 0, 0, 1, 14, 97
"/home/xiangui/ysyx-workbench/am-kernels/kernels/demo/src/hanoi/hanoi.c", "C", 0, 47, 0, 0, 0, 1, 13, 61
"/home/xiangui/ysyx-workbench/am-kernels/kernels/demo/src/life/life.c", "C", 0, 47, 0, 0, 0, 1, 9, 57
"/home/xiangui/ysyx-workbench/am-kernels/kernels/demo/src/main.c", "C", 0, 40, 0, 0, 0, 0, 5, 45
"/home/xiangui/ysyx-workbench/am-kernels/kernels/hello/Makefile", "Makefile", 3, 0, 0, 0, 0, 0, 1, 4
"/home/xiangui/ysyx-workbench/am-kernels/kernels/hello/hello.c", "C", 0, 11, 0, 0, 0, 0, 3, 14
"/home/xiangui/ysyx-workbench/am-kernels/kernels/litenes/Makefile", "Makefile", 3, 0, 0, 0, 0, 0, 1, 4
"/home/xiangui/ysyx-workbench/am-kernels/kernels/litenes/src/common.c", "C", 0, 11, 0, 0, 0, 2, 4, 17
"/home/xiangui/ysyx-workbench/am-kernels/kernels/litenes/src/common.h", "C", 0, 22, 0, 0, 0, 4, 8, 34
"/home/xiangui/ysyx-workbench/am-kernels/kernels/litenes/src/cpu-addressing.c", "C", 0, 79, 0, 0, 0, 4, 19, 102
"/home/xiangui/ysyx-workbench/am-kernels/kernels/litenes/src/cpu-internal.h", "C++", 0, 0, 51, 0, 0, 2, 11, 64
"/home/xiangui/ysyx-workbench/am-kernels/kernels/litenes/src/cpu.c", "C", 0, 506, 0, 0, 0, 27, 74, 607
"/home/xiangui/ysyx-workbench/am-kernels/kernels/litenes/src/cpu.h", "C++", 0, 0, 11, 0, 0, 1, 6, 18
"/home/xiangui/ysyx-workbench/am-kernels/kernels/litenes/src/fce.c", "C", 0, 109, 0, 0, 0, 3, 29, 141
"/home/xiangui/ysyx-workbench/am-kernels/kernels/litenes/src/fce.h", "C++", 0, 0, 23, 0, 0, 0, 6, 29
"/home/xiangui/ysyx-workbench/am-kernels/kernels/litenes/src/main.c", "C", 0, 18, 0, 0, 0, 0, 5, 23
"/home/xiangui/ysyx-workbench/am-kernels/kernels/litenes/src/mario-rom.c", "C", 0, 3418, 0, 0, 0, 0, 1, 3419
"/home/xiangui/ysyx-workbench/am-kernels/kernels/litenes/src/memory.c", "C", 0, 36, 0, 0, 0, 1, 5, 42
"/home/xiangui/ysyx-workbench/am-kernels/kernels/litenes/src/memory.h", "C++", 0, 0, 9, 0, 0, 2, 5, 16
"/home/xiangui/ysyx-workbench/am-kernels/kernels/litenes/src/mmc.c", "C", 0, 24, 0, 0, 0, 0, 8, 32
"/home/xiangui/ysyx-workbench/am-kernels/kernels/litenes/src/mmc.h", "C++", 0, 0, 6, 0, 0, 0, 3, 9
"/home/xiangui/ysyx-workbench/am-kernels/kernels/litenes/src/ppu.c", "C", 0, 310, 0, 0, 0, 51, 72, 433
"/home/xiangui/ysyx-workbench/am-kernels/kernels/litenes/src/ppu.h", "C++", 0, 0, 30, 0, 0, 0, 12, 42
"/home/xiangui/ysyx-workbench/am-kernels/kernels/litenes/src/psg.c", "C", 0, 45, 0, 0, 0, 2, 8, 55
"/home/xiangui/ysyx-workbench/am-kernels/kernels/litenes/src/psg.h", "C++", 0, 0, 16, 0, 0, 0, 5, 21
"/home/xiangui/ysyx-workbench/am-kernels/kernels/nemu/Makefile", "Makefile", 24, 0, 0, 0, 0, 0, 8, 32
"/home/xiangui/ysyx-workbench/am-kernels/kernels/slider/Makefile", "Makefile", 3, 0, 0, 0, 0, 0, 1, 4
"/home/xiangui/ysyx-workbench/am-kernels/kernels/slider/main.c", "C", 0, 25, 0, 0, 0, 1, 7, 33
"/home/xiangui/ysyx-workbench/am-kernels/kernels/snake/Makefile", "Makefile", 3, 0, 0, 0, 0, 0, 1, 4
"/home/xiangui/ysyx-workbench/am-kernels/kernels/snake/snake.c", "C", 0, 158, 0, 0, 0, 0, 31, 189
"/home/xiangui/ysyx-workbench/am-kernels/kernels/thread-os/Makefile", "Makefile", 3, 0, 0, 0, 0, 0, 1, 4
"/home/xiangui/ysyx-workbench/am-kernels/kernels/thread-os/thread-os.c", "C", 0, 56, 0, 0, 0, 2, 13, 71
"/home/xiangui/ysyx-workbench/am-kernels/kernels/typing-game/Makefile", "Makefile", 3, 0, 0, 0, 0, 0, 1, 4
"/home/xiangui/ysyx-workbench/am-kernels/kernels/typing-game/font.c", "C", 0, 28, 0, 0, 0, 0, 1, 29
"/home/xiangui/ysyx-workbench/am-kernels/kernels/typing-game/game.c", "C", 0, 151, 0, 0, 0, 0, 25, 176
"/home/xiangui/ysyx-workbench/am-kernels/kernels/yield-os/Makefile", "Makefile", 3, 0, 0, 0, 0, 0, 1, 4
"/home/xiangui/ysyx-workbench/am-kernels/kernels/yield-os/yield-os.c", "C", 0, 27, 0, 0, 0, 0, 5, 32
"/home/xiangui/ysyx-workbench/am-kernels/tests/alu-tests/Makefile", "Makefile", 8, 0, 0, 0, 0, 0, 4, 12
"/home/xiangui/ysyx-workbench/am-kernels/tests/alu-tests/build/alu_test.c", "C", 0, 22365, 0, 0, 0, 0, 1, 22366
"/home/xiangui/ysyx-workbench/am-kernels/tests/alu-tests/gen_alu_test.c", "C", 0, 102, 0, 0, 0, 7, 22, 131
"/home/xiangui/ysyx-workbench/am-kernels/tests/am-tests/Makefile", "Makefile", 3, 0, 0, 0, 0, 0, 1, 4
"/home/xiangui/ysyx-workbench/am-kernels/tests/am-tests/include/amtest.h", "C++", 0, 0, 19, 0, 0, 0, 6, 25
"/home/xiangui/ysyx-workbench/am-kernels/tests/am-tests/src/main.c", "C", 0, 36, 0, 0, 0, 0, 4, 40
"/home/xiangui/ysyx-workbench/am-kernels/tests/am-tests/src/tests/audio.c", "C", 0, 22, 0, 0, 0, 1, 5, 28
"/home/xiangui/ysyx-workbench/am-kernels/tests/am-tests/src/tests/devscan.c", "C", 0, 55, 0, 0, 0, 0, 15, 70
"/home/xiangui/ysyx-workbench/am-kernels/tests/am-tests/src/tests/hello.c", "C", 0, 6, 0, 0, 0, 0, 2, 8
"/home/xiangui/ysyx-workbench/am-kernels/tests/am-tests/src/tests/intr.c", "C", 0, 24, 0, 0, 0, 0, 3, 27
"/home/xiangui/ysyx-workbench/am-kernels/tests/am-tests/src/tests/keyboard.c", "C", 0, 30, 0, 0, 0, 0, 6, 36
"/home/xiangui/ysyx-workbench/am-kernels/tests/am-tests/src/tests/mp.c", "C", 0, 6, 0, 0, 0, 0, 2, 8
"/home/xiangui/ysyx-workbench/am-kernels/tests/am-tests/src/tests/rtc.c", "C", 0, 16, 0, 0, 0, 0, 2, 18
"/home/xiangui/ysyx-workbench/am-kernels/tests/am-tests/src/tests/video.c", "C", 0, 76, 0, 0, 0, 1, 14, 91
"/home/xiangui/ysyx-workbench/am-kernels/tests/am-tests/src/tests/vm.c", "C", 0, 78, 0, 0, 0, 0, 13, 91
"/home/xiangui/ysyx-workbench/am-kernels/tests/cpu-tests/Makefile", "Makefile", 26, 0, 0, 0, 0, 0, 11, 37
"/home/xiangui/ysyx-workbench/am-kernels/tests/cpu-tests/include/trap.h", "C++", 0, 0, 10, 0, 0, 0, 4, 14
"/home/xiangui/ysyx-workbench/am-kernels/tests/cpu-tests/tests/add-longlong.c", "C", 0, 17, 0, 0, 0, 0, 6, 23
"/home/xiangui/ysyx-workbench/am-kernels/tests/cpu-tests/tests/add.c", "C", 0, 19, 0, 0, 0, 0, 7, 26
"/home/xiangui/ysyx-workbench/am-kernels/tests/cpu-tests/tests/bit.c", "C", 0, 40, 0, 0, 0, 0, 7, 47
"/home/xiangui/ysyx-workbench/am-kernels/tests/cpu-tests/tests/bubble-sort.c", "C", 0, 29, 0, 0, 0, 0, 11, 40
"/home/xiangui/ysyx-workbench/am-kernels/tests/cpu-tests/tests/crc32.c", "C", 0, 38, 0, 0, 0, 3, 7, 48
"/home/xiangui/ysyx-workbench/am-kernels/tests/cpu-tests/tests/div.c", "C", 0, 17, 0, 0, 0, 0, 5, 22
"/home/xiangui/ysyx-workbench/am-kernels/tests/cpu-tests/tests/dummy.c", "C", 0, 3, 0, 0, 0, 0, 2, 5
"/home/xiangui/ysyx-workbench/am-kernels/tests/cpu-tests/tests/fact.c", "C", 0, 15, 0, 0, 0, 0, 6, 21
"/home/xiangui/ysyx-workbench/am-kernels/tests/cpu-tests/tests/fib.c", "C", 0, 12, 0, 0, 0, 0, 5, 17
"/home/xiangui/ysyx-workbench/am-kernels/tests/cpu-tests/tests/goldbach.c", "C", 0, 27, 0, 0, 0, 0, 8, 35
"/home/xiangui/ysyx-workbench/am-kernels/tests/cpu-tests/tests/hello-str.c", "C", 0, 13, 0, 0, 0, 0, 5, 18
"/home/xiangui/ysyx-workbench/am-kernels/tests/cpu-tests/tests/if-else.c", "C", 0, 21, 0, 0, 0, 0, 8, 29
"/home/xiangui/ysyx-workbench/am-kernels/tests/cpu-tests/tests/leap-year.c", "C", 0, 12, 0, 0, 0, 0, 5, 17
"/home/xiangui/ysyx-workbench/am-kernels/tests/cpu-tests/tests/load-store.c", "C", 0, 34, 0, 0, 0, 0, 12, 46
"/home/xiangui/ysyx-workbench/am-kernels/tests/cpu-tests/tests/matrix-mul.c", "C", 0, 54, 0, 0, 0, 0, 7, 61
"/home/xiangui/ysyx-workbench/am-kernels/tests/cpu-tests/tests/max.c", "C", 0, 21, 0, 0, 0, 0, 7, 28
"/home/xiangui/ysyx-workbench/am-kernels/tests/cpu-tests/tests/mersenne.c", "C", 0, 31, 0, 0, 0, 1, 3, 35
"/home/xiangui/ysyx-workbench/am-kernels/tests/cpu-tests/tests/min3.c", "C", 0, 25, 0, 0, 0, 0, 7, 32
"/home/xiangui/ysyx-workbench/am-kernels/tests/cpu-tests/tests/mov-c.c", "C", 0, 20, 0, 0, 0, 0, 6, 26
"/home/xiangui/ysyx-workbench/am-kernels/tests/cpu-tests/tests/movsx.c", "C", 0, 30, 0, 0, 0, 0, 4, 34
"/home/xiangui/ysyx-workbench/am-kernels/tests/cpu-tests/tests/mul-longlong.c", "C", 0, 19, 0, 0, 0, 0, 8, 27
"/home/xiangui/ysyx-workbench/am-kernels/tests/cpu-tests/tests/pascal.c", "C", 0, 23, 0, 0, 0, 0, 8, 31
"/home/xiangui/ysyx-workbench/am-kernels/tests/cpu-tests/tests/prime.c", "C", 0, 21, 0, 0, 0, 0, 5, 26
"/home/xiangui/ysyx-workbench/am-kernels/tests/cpu-tests/tests/quick-sort.c", "C", 0, 35, 0, 0, 0, 0, 15, 50
"/home/xiangui/ysyx-workbench/am-kernels/tests/cpu-tests/tests/recursion.c", "C", 0, 37, 0, 0, 0, 0, 10, 47
"/home/xiangui/ysyx-workbench/am-kernels/tests/cpu-tests/tests/select-sort.c", "C", 0, 31, 0, 0, 0, 0, 12, 43
"/home/xiangui/ysyx-workbench/am-kernels/tests/cpu-tests/tests/shift.c", "C", 0, 26, 0, 0, 0, 0, 11, 37
"/home/xiangui/ysyx-workbench/am-kernels/tests/cpu-tests/tests/shuixianhua.c", "C", 0, 20, 0, 0, 0, 0, 7, 27
"/home/xiangui/ysyx-workbench/am-kernels/tests/cpu-tests/tests/string.c", "C", 0, 21, 0, 0, 0, 0, 7, 28
"/home/xiangui/ysyx-workbench/am-kernels/tests/cpu-tests/tests/sub-longlong.c", "C", 0, 17, 0, 0, 0, 0, 6, 23
"/home/xiangui/ysyx-workbench/am-kernels/tests/cpu-tests/tests/sum.c", "C", 0, 11, 0, 0, 0, 0, 4, 15
"/home/xiangui/ysyx-workbench/am-kernels/tests/cpu-tests/tests/switch.c", "C", 0, 23, 0, 0, 0, 0, 7, 30
"/home/xiangui/ysyx-workbench/am-kernels/tests/cpu-tests/tests/to-lower-case.c", "C", 0, 14, 0, 0, 0, 0, 5, 19
"/home/xiangui/ysyx-workbench/am-kernels/tests/cpu-tests/tests/unalign.c", "C", 0, 12, 0, 0, 0, 0, 7, 19
"/home/xiangui/ysyx-workbench/am-kernels/tests/cpu-tests/tests/wanshu.c", "C", 0, 19, 0, 0, 0, 0, 6, 25
"/home/xiangui/ysyx-workbench/am-kernels/tests/klib-tests/Makefile", "Makefile", 28, 0, 0, 0, 0, 0, 14, 42
"/home/xiangui/ysyx-workbench/am-kernels/tests/klib-tests/tests/memset.c", "C", 0, 41, 0, 0, 0, 2, 7, 50
"Total", "-", -187, 28592, -1162, 236, -35, 856, 444, 28744